333333333333333333333333
300000000000000000000003
300p00000030000030000003
300000300000300000300003
300000200000200000200003
300000300000300000300003
300000300000300000300003
300000400000400000400003
300000300000300000300003
300000300000300000300003
300000500000500000500003
300000300000300000300003
300000300000300000300003
300000000000000000000003
333333333333333333333333
