333333333333333333333333
322222222222222222222223
322p00000030000030000003
300000300000300000300003
300000200000200000200003
300000300000300000300003
300000300004444444444003
300000400000400000400003
333333333333333300000003
300000322222300000300003
300000500000500000500003
300000300000300000300003
300022222222222222200003
300000000000000000000001
333333333333333333333333
